11111111111
1C00001E001
10P01001001
10001000001
11111111111
