11111111111
100B001E0E1
10P01001001
11B1100C001
11111111111
