11111111111
100B001E0C1
10P01001001
11B11000001
11111111111
