11111111111
1000001E001
10P010C1001
10001000001
11111111111