11111111111
1000001E0C1
10P01001001
10001000001
11111111111
