11111111111
100B001E0C1
10P01001001
10B01000001
11111111111
