11111111111111111111111111111
10000000100000000000000000001
100010001C0000000000000000001
10001000111111111111111111001
10001000000000000000010001001
10001111100010001000010001001
10001000100010001000010001001
100P1E00000010001111110001001
10001000000010000000000000001
11111111111111111111111111111
