11111111111111111111111111111
10000000100000000000000000001
100B10001C000B000B0000B000001
10001000111111111111111111001
10001000000000000000010C01001
100011111000100010B0010001001
10001000100010B0100C010001001
10P01E00000B10001111110B01001
10001C00000010000000000000001
11111111111111111111111111111
